11111111111111111
1E3000010003000C1
100010C1000000001
1000011C100C11101
100000300111C0101
111111101000003C1
131313100010000P1
11111111111111111