111111111111111111111
130000003010030000C01
101110111010111011111
1011300E1C11111003101
101111111111101011111
130000300000000311111
101111111111113011011
130000030111000000031
101101111101111110111
10110C1P00000000000C1
111111111111111111111