1111111111
1E11111111
1003333331
1033333301
1333333001
1333333001
1333333001
1333333001
1333333001
1333333001
1C00000P01
1111111111