1111111111111111111111
1C100000001000000000P1
1030011110300100031111
11110130111110111C10E1
1C010111CCC31111C13001
130000C101111000010001
1003110100001311110001
1003130000001000000001
1031001111111111111101
1C00000000000000000031
1111111111111111111111